1111111111111111001100C0P00001