111111111111111
1001100C0P00001
10C100001010001
101100000001C01
100000011111101
111C00000001001
1E00111000C0001
111111111111111