111111111111111
1001100C00P0001
10C101001010001
101101000001C01
100001011111101
111C00000001001
1E00111000C0001
111111111111111