111111111
100100101
10010C001
1C0001101
1100P10C1
100111001
1010E0101
1010C0101
1110010C1
1C0000001
111111111